BBBBBBBBBBBBBBBBBBBBBBBBBBBBBBBBBBBBBBBB
B++++++++++++++++++++++++++++++++++++++B
B++++++++++++++++++++++++++++++++++++++B
B+++++++++++++++++SS+++++++++++++++++++B
B++++++++++++++++++++++++++++++++++++++B
B++++++++++++++++++++++++++++++++++++++B
B++++++++++++++++++++++++++++++++++++++B
B++++++++++++++++++++++++++++++++++++++B
B++++++++++++++++++++++++++++++++++++++B
B++++++BBBBBBBBBBBBBBBBBBBBBBBBBBBB++++B
B+++++++++B+++++B+++++B+++++B++++++++++B
B++++++++++++++++++++++++++++++++++++++B
B++++++++++++++++++++++++++++++++++++++B
B++++++++++++B+++++B+++++B+++++B+++++++B
B++++++++++++++++++++++++++++++++++++++B
B++++++++++++++++++++++++++++++++++++++B
B+++++++++B+++++B+++++B+++++B++++++++++B
B++++++++++++++++++++++++++++++++++++++B
B++++++++++++++++++++++++++++++++++++++B
B++++++++++++B+++++B+++++B+++++B+++++++B
B++++++++++++++++++++++++++++++++++++++B
B++++++++++++++++++++++++++++++++++++++B
B+++++++++B+++++B+++++B+++++B++++++++++B
B++++++++++++++++++++++++++++++++++++++B
BBBBBBBBBBBBBBBBBBBBBBBBBBBBBBBBBBBBBBBB