BBBBBBBBBBBBBBBBBBBBBBBBBBBBBBBBBBBBBBBBBBBBBBBBBB
B++++++++++++++++++++++++++++++++++++++++++++++++B
B++++++++++++++++++++++++++++++++++++++++++++++++B
B+++++++++++++++++SS+++++++++++++++++++++++++++++B
B++++++++++++++++++++++++++++++++++++++++++++++++B
B++++++++++++++++++++++++++++++++++++++++++++++++B
B++++++++++++++++++++++++++++++++++++++++++++++++B
B++++++++++BBBBBBBBBBBBBBBBBBBBBBBBBBBB++++++++++B
B++++++++++++++++++++++++++++++++++++++++++++++++B
B+++++++++++++++++++++++BBBBBBBBBB+++++++++++++++B
B+++++++++++++++++++++++B++++++++++++++++++++++++B
B+++++++++++++BBBBBBBBBBB++++++++++++++++++++++++B
B+++++++++++++BBBBBBBBBBB++++++++++++++++++++++++B
B+++++++++++++++++++++++B++++++++++++++++++++++++B
B+++++++++++++++++++++++BBBBBBBBBB+++++++++++++++B
B++++++++++++++++++++++++++++++++++++++++++++++++B
B++++++++++BBBBBBBBBBBBBBBBBBBBBBBBBBBB++++++++++B
B++++++++++++++++++++++++++++++++++++++++++++++++B
B++++++++++++++++++++++++++++++++++++++++++++++++B
B++++++++++++++++++++++++++++++++++++++++++++++++B
B++++++++++++++++++++++++++++++++++++++++++++++++B
B++++++++++++++++++++++++++++++++++++++++++++++++B
B++++++++++++++++++++++++++++++++++++++++++++++++B
B++++++++++++++++++++++++++++++++++++++++++++++++B
BBBBBBBBBBBBBBBBBBBBBBBBBBBBBBBBBBBBBBBBBBBBBBBBBB