++++++++++++++++++++++++++++++++++++++++
+++++++++++++++++++++++++BBBBBBBBBBBB+++
++++++++++++++++++++++++++++++++++++B+++
+++BBBBBBBBBBBBBBBBBBBBB++++++++++++B+++
+++B++++++++++++++++++++++++++++++++B+++
+++B++++++++++++++++++++++++++++++++B+++
+++B++++++++++++++++++++++++++++++++B+++
+++B++++++++++++BBBBBBBBBBBBBBBBBBBBB+++
+++B++++++++++++++++++++++++++++++++++++
+++BBBBBBBBBBBB+++++++++++++++++++++++++
++++++++++++++++++SS++++++++++++++++++++
+++++++++++++++++++++++++BBBBBBBBBBBB+++
++++++++++++++++++++++++++++++++++++B+++
+++BBBBBBBBBBBBBBBBBBBBB++++++++++++B+++
+++B++++++++++++++++++++++++++++++++B+++
+++B++++++++++++++++++++++++++++++++B+++
+++B++++++++++++++++++++++++++++++++B+++
+++B++++++++++++BBBBBBBBBBBBBBBBBBBBB+++
+++B++++++++++++++++++++++++++++++++++++
+++BBBBBBBBBBBB+++++++++++++++++++++++++
++++++++++++++++++++++++++++++++++++++++