+++++++++++++++++++++++++++++++++++++++
+++++++++++++++++++++++++++++++++++++++
+++++++++++++++++++++++++++++++++++++++
+++++++++++++++++++++++++++++++++++++++
+++++++++++++++++++++++++++++++++++++++
+++++BBBBBBBBBBBBBBBBBBBBBBBBBBBBB+++++
+++++B+++++++++++SS++++++++++++++B+++++
+++++B+++++++++++++++++++++++++++B+++++
+++++B+++++++++++++++++++++++++++B+++++
+++++B+++++++++++++++++++++++++++B+++++
+++++++++++++++++++++++++++++++++++++++
+++++++++++++++++++++++++++++++++++++++
+++++B+++++++++++++++++++++++++++B+++++
+++++B+++++++++++++++++++++++++++B+++++
+++++B+++++++++++++++++++++++++++B+++++
+++++B+++++++++++++++++++++++++++B+++++
+++++BBBBBBBBBBBBBBBBBBBBBBBBBBBBB+++++
+++++++++++++++++++++++++++++++++++++++
+++++++++++++++++++++++++++++++++++++++
+++++++++++++++++++++++++++++++++++++++
+++++++++++++++++++++++++++++++++++++++
+++++++++++++++++++++++++++++++++++++++