++++++++++++++++++++++++++++++++++++++++
++++++++++++++++++++++++++++++++++++++++
++++++++++++++++++++++++++++++++++++++++
++++++++++++++++++SS++++++++++++++++++++
++++++++++++++++++++++++++++++++++++++++
++++++++++++++++++++++++++++++++++++++++
++++++++++++++++++++++++++++++++++++++++
++++++++++++++++++++++++++++++++++++++++
++++++++++++++++++BBBB++++++++++++++++++
++++++++++++++++++BBBB++++++++++++++++++
++++++++++++++++++BBBB++++++++++++++++++
++++++++++++++++++BBBB++++++++++++++++++
++++++++++++++++++BBBB++++++++++++++++++
++++++++++++++++++BBBB+++++++++++B++++++
++++++++++++B+++++BBBB+++++++++++B++++++
+++++++++++BBB++++BBBB+++++++++++B++++++
++++++++++BBBB++++BBBB+++++B+++++BBB++++
++B+++++++BBBB++++BBBB+++++BBB+++BBB++++
++BBBB++++BBBB++++BBBB+++++BBB+++BBBBB++
++BBBB+++BBBBB++++BBBB++++BBBB+++BBBBB++