++++++++++++++++++++++++++++++++++++++++
+++++BBBBBBB++++++++++++++++BBBBBBB+++++
+++++BBBBBBB++++++++++++++++BBBBBBB+++++
+++++BBBBBBB++++++++++++++++BBBBBBB+++++
+BBBBBBBBBBB++++++++++++++++BBBBBBBBBBB+
+BBBBBBBBBBB++++++++++++++++BBBBBBBBBBB+
+BBBBBBBBBBB++++++++++++++++BBBBBBBBBBB+
++++++++++++++++++++++++++++++++++++++++
++++++++++++++++++++++++++++++++++++++++
++++++++++++++++++++++++++++++++++++++++
+++++++++++++++++SS+++++++++++++++++++++
++++++++++++++++++++++++++++++++++++++++
++++++++++++++++++++++++++++++++++++++++
++++++++++++++++++++++++++++++++++++++++
+BBBBBBBBBBB++++++++++++++++BBBBBBBBBBB+
+BBBBBBBBBBB++++++++++++++++BBBBBBBBBBB+
+BBBBBBBBBBB++++++++++++++++BBBBBBBBBBB+
+++++BBBBBBB++++++++++++++++BBBBBBB+++++
+++++BBBBBBB++++++++++++++++BBBBBBB+++++
+++++BBBBBBB++++++++++++++++BBBBBBB+++++
++++++++++++++++++++++++++++++++++++++++