+++++++++++++++++++++++++++++++++++++++++
+++++++++++++++++++++++++++++++++++++++++
+++++++++++++++++++++++++++++++++++++++++
BBBBB+++++++++++++SS+++++++++++++++++++++
++++BBBBB++++++++++++++++++++++++++++++++
++++++++BBBBB++++++++++++++++++++++++++++
++++++++++++BBBBB++++++++++++++++++++++++
++++++++++++++++BBBBB++++++++++++++++++++
++++++++++++++++++++BBBBB++++++++++++++++
++++++++++++++++++++++++BBBBB++++++++++++
++++++++++++++++++++++++++++BBBBB++++++++
++++++++++++++++++++++++++++++++BBBBB++++
BBBB++++++++++++++++++++++++++++++++BBBBB
+++BBBBB+++++++++++++++++++++++++++++++++
+++++++BBBBB+++++++++++++++++++++++++++++
+++++++++++BBBBB+++++++++++++++++++++++++
+++++++++++++++BBBBB+++++++++++++++++++++
+++++++++++++++++++BBBBB+++++++++++++++++
+++++++++++++++++++++++BBBBB+++++++++++++
+++++++++++++++++++++++++++BBBBB+++++++++