++++++++++++++++++++++++++++++++++++++++
++++++++++++++++++++++++++++++++++++++++
++++++++++++++++++++++++++++++++++++++++
++++++BBBBBBB+++SS+++++++++BBBBBBB++++++
++++++BBBBBBB++++++++++++++BBBBBBB++++++
++++++BBBBBBB++++++++++++++BBBBBBB++++++
++++++++++++++++++++++++++++++++++++++++
++++++++++++++++BBBBBBBB++++++++++++++++
++++++++++++++++BBBBBBBB++++++++++++++++
++++++++++++++++BBBBBBBB++++++++++++++++
++++++++++++++++BBBBBBBB++++++++++++++++
++++++++++++++++BBBBBBBB++++++++++++++++
++++++++++++++++BBBBBBBB++++++++++++++++
++++++B++++++++++++++++++++++++++B++++++
+++++++++B++++++++++++++++++++B+++++++++
++++++++++++B++++++++++++++B++++++++++++
+++++++++++++++BBBBBBBBBB+++++++++++++++
++++++++++++++++++++++++++++++++++++++++
++++++++++++++++++++++++++++++++++++++++
++++++++++++++++++++++++++++++++++++++++