++++++++++++++++++++++++++++++++++++++++
++++++++++++++++++++++++++++++++++++++++
++++++++++++++++++++++++++++++++++++++++
++++++++++++++++++SS++++++++++++++++++++
BBBBBBB+++++++++++++++++++++++++++++++++
+++++++BBBBBBB++++++++++++++++++++++++++
++++++++++++++BBBBBBB+++++++++++++++++++
++++++++++++++++++++B+++++++++++++++++++
++++++++++++++++++++B+++++++++++++++++++
++++++++++++++++++++++++++++++++++++++++
++++++++++++++++++++++++++++++++++++++++
++++++++++++++++++++B+++++++++++++++++++
++++++++++++++++++++B+++++++++++++++++++
++++++++++++++BBBBBBB+++++++++++++++++++
+++++++BBBBBBB++++++++++++++++++++++++++
BBBBBBB+++++++++++++++++++++++++++++++++
++++++++++++++++++++++++++++++++++++++++
++++++++++++++++++++++++++++++++++++++++
++++++++++++++++++++++++++++++++++++++++
++++++++++++++++++++++++++++++++++++++++