BBBBBBBBBBBBBBBBBBBBBBBBBBBBBBBBBBBBBBBBBBBBBBBBBB
B                                                B
B                                                B
B                 SS                             B
B                                                B
B    B                                      B    B
B     B                                    B     B
B      B                                  B      B
B       B                                B       B
B        B                              B        B
B         B                            B         B
B          B                          B          B
B           B                        B           B
B            B                      B            B
B             B                    B             B
B              B                  B              B
B               B                B               B
B                B              B                B
B                 B            B                 B
B                  B          B                  B
B                   B        B                   B
B                    B      B                    B
B                                                B
B                                                B
BBBBBBBBBBBBBBBBBBBBBBBBBBBBBBBBBBBBBBBBBBBBBBBBBB
