++++BBBBBBBBBBBBBBBBBBBBBBBBBBBBBBBBBBBBBBBBBB++++
++++++BBBBBBBBBBBBBBBBBBBBBBBBBBBBBBBBBBBBBB++++++
++++++++BBBBBBBBBBBBBBBBBBBBBBBBBBBBBBBBBB++++++++
++++++++++BBBBBBBBBBBBBBBBBBBBBBBBBBBBBB++++++++++
++++++++++++BBBBBBBBBBBBBBBBBBBBBBBBBB++++++++++++
++++++++++++++BBBBBBBBBBBBBBBBBBBBBB++++++++++++++
++++++++++++++++BBBBBBBBBBBBBBBBBB++++++++++++++++
++++++++++++++++++BBBBBBBBBBBBBB++++++++++++++++++
++++++++++++++++++++BBBBBBBBBB++++++++++++++++++++
++++++++++++++++++++++BBBBBB++++++++++++++++++++++
++++++++++++++++++++++++BB++++++++++++++++++++++++
++++++++++++++++++++++++++++++++++++++++++++++++++
++++++++++++++++++++++++++++++++++++++++++++++++++
++++++++++++++++++++++++++++++++++++++++++++++++++
+++++++++++++++++++++++SS+++++++++++++++++++++++++
++++++++++++++++++++++++++++++++++++++++++++++++++
++++++++++++++++++++++++++++++++++++++++++++++++++
++++++++++++++++++++++++++++++++++++++++++++++++++
++++++++++++++++++++++++++++++++++++++++++++++++++
++++++++++++++++++++++++BB++++++++++++++++++++++++
++++++++++++++++++++++BBBBBB++++++++++++++++++++++
++++++++++++++++++++BBBBBBBBBB++++++++++++++++++++
++++++++++++++++++BBBBBBBBBBBBBB++++++++++++++++++
++++++++++++++++BBBBBBBBBBBBBBBBBB++++++++++++++++
++++++++++++++BBBBBBBBBBBBBBBBBBBBBB++++++++++++++
++++++++++++BBBBBBBBBBBBBBBBBBBBBBBBBB++++++++++++
++++++++++BBBBBBBBBBBBBBBBBBBBBBBBBBBBBB++++++++++
++++++++BBBBBBBBBBBBBBBBBBBBBBBBBBBBBBBBBB++++++++
++++++BBBBBBBBBBBBBBBBBBBBBBBBBBBBBBBBBBBBBB++++++
++++BBBBBBBBBBBBBBBBBBBBBBBBBBBBBBBBBBBBBBBBBB++++