++++++++++++++++++++++++++++++++++++++++++++
++++++++++++++++++++++++++++++++++++++++++++
++++BBBB++++BBBB++++BBBB++++BBBB++++BBBB++++
++++BBBB++++BBBB++++BBBB++++BBBB++++BBBB++++
++++++++++++++++++++++++++++++++++++++++++++
+++++++++SS+++++++++++++++++++++++++++++++++
++++BBBB++++BBBB++++BBBB++++BBBB++++BBBB++++
++++BBBB++++BBBB++++BBBB++++BBBB++++BBBB++++
++++++++++++++++++++++++++++++++++++++++++++
++++++++++++++++++++++++++++++++++++++++++++
++++BBBB++++BBBB++++BBBB++++BBBB++++BBBB++++
++++BBBB++++BBBB++++BBBB++++BBBB++++BBBB++++
++++++++++++++++++++++++++++++++++++++++++++
++++++++++++++++++++++++++++++++++++++++++++
++++BBBB++++BBBB++++BBBB++++BBBB++++BBBB++++
++++BBBB++++BBBB++++BBBB++++BBBB++++BBBB++++
++++++++++++++++++++++++++++++++++++++++++++
++++++++++++++++++++++++++++++++++++++++++++
++++BBBB++++BBBB++++BBBB++++BBBB++++BBBB++++
++++BBBB++++BBBB++++BBBB++++BBBB++++BBBB++++
++++++++++++++++++++++++++++++++++++++++++++
++++++++++++++++++++++++++++++++++++++++++++