+++++++++++++++++++++++++++++++++++++++
+++++++++++++++++++++++++++++++++++++++
++++++BBBBB++++++BBBBB++++++BBBBB++++++
++++++BBBBB++++++BBBBB++++++BBBBB++++++
++++++BBBBB++++++BBBBB++++++BBBBB++++++
++++++BBBBB++++++BBBBB++++++BBBBB++++++
++++++BBBBB++++++BBBBB++++++BBBBB++++++
++++++BBBBB++++++BBBBB++++++BBBBB++++++
++++++BBBBB++++++BBBBB++++++BBBBB++++++
+++++++++++++++++++++++++++++++++++++++
+++++++++++++++++++++++++++++++++++++++
++++++BBBBB++++++BBBBB++++++BBBBB++++++
++++++BBBBB++++++BBBBB++++++BBBBB++++++
++++++BBBBB++++++BBBBB++++++BBBBB++++++
++++++BBBBB++++++BBBBB++++++BBBBB++++++
++++++BBBBB++++++BBBBB++++++BBBBB++++++
++++++BBBBB++++++BBBBB++++++BBBBB++++++
++++++BBBBB++++++BBBBB++++++BBBBB++++++
++++++++++++++++++SS+++++++++++++++++++
+++++++++++++++++++++++++++++++++++++++