+++++++++++++++++SS++++++++++++++++++++++++
+++B+++++++++++B+++++++++++B+++++++++++B+++
+++++B+++++++B+++B+++++++B+++B+++++++B+++++
+++++++B+++B+++++++B+++B+++++++B+++B+++++++
+++++++++B+++++++++++B+++++++++++B+++++++++
+++++++B+++B+++++++B+++B+++++++B+++B+++++++
+++++B+++++++B+++B+++++++B+++B+++++++B+++++
+++B+++++++++++B+++++++++++B+++++++++++B+++
+++++B+++++++B+++B+++++++B+++B+++++++B+++++
+++++++B+++B+++++++B+++B+++++++B+++B+++++++
+++++++++B+++++++++++B+++++++++++B+++++++++
+++++++B+++B+++++++B+++B+++++++B+++B+++++++
+++++B+++++++B+++B+++++++B+++B+++++++B+++++
+++B+++++++++++B+++++++++++B+++++++++++B+++
+++++B+++++++B+++B+++++++B+++B+++++++B+++++
+++++++B+++B+++++++B+++B+++++++B+++B+++++++
+++++++++B+++++++++++B+++++++++++B+++++++++
+++++++B+++B+++++++B+++B+++++++B+++B+++++++
+++++B+++++++B+++B+++++++B+++B+++++++B+++++
+++B+++++++++++B+++++++++++B+++++++++++B+++
+++++++++++++++++++++++++++++++++++++++++++