BBBBBBBBBBBBBBBBBBBBBBBBBBBBBBBBBBBBBBBBBBBBBBBBBBBBBBBBBBBBBBBBBBBBBBBBBBBBBBBBBBBBBBBBBBBBBBBBBBBB
B                                                                                                  B
B                                                                                                  B
B                                                                                                  B
B                                            BBBBBBBBBBBBBBBBBBBBBBBBBBBBBBB                       B
B                                            B                             B                       B
B                                            B                             B                       B
B                                            B                             B                       B
B                                            B                             B                       B
B                                            BBBBBB                  BBBBBBB                       B
B                                                                                                  B
B                                                                                                  B
B                                                                                                  B
B                                                                                                  B
B                                                                                                  B
B                                                                                                  B
B                                                                                                  B
B                     BBBBBBBBBBBBBBBBBBBBBBBBBBBBBB                                               B
B                     B                            B                                               B
B                     B                            B                                               B
B                     B                            B                                               B
B                     B                            B                                               B
B                     B                SS          B                                               B
B                     B                                                                            B
B                     B                                                                            B
B                     BBBBBBBBBBBBBBBBBBBBBBBBBBBBBB                                               B
B                                                                                                  B
B                                                                                                  B
B                                                                                                  B
B                                                                                                  B
B                                                                                                  B
B                                                                                                  B
B                                                                                                  B
BBBBBBBBBBBBBBBBBBBBBBBBBBBBBBBBBBBBBBBBBBBBBBBBBBBBBBBBBBBBBBBBBBBBBBBBBBBBBBBBBBBBBBBBBBBBBBBBBBBB
