BBBBBBBBBBBBBBBBBBBBBBBBBBBBBBBBBBBBBBBBBBBBBBBBBBBBBBBBBBBBBBBBBBBBBBBBBBBBBBBBBBBBBBBBBBBBBBBBBBBB
B                                            B                                                     B
B                                            B                                                     B
B                                            B                                                     B
B                                            B                                                     B
B                                            B                                                     B
B                                            B                                                     B
B                                            B                                                     B
B                                            B                                                     B
B                                            BBBBBB                                                B
B                                                                                                  B
B                                                                                                  B
B                                                                                                  B
B                                                                                                  B
B                                                                                                  B
B                                                                                                  B
B                                                                                                  B
B                     BBBBBBBBBBBBBBBBBBBBBBBBBBBBBB                                               B
B                     B                            B                                               B
B                     B                            B                                               B
B                     B                            B                                               B
B                     B                            B                                               B
B                     B                SS          B                                               B
B                     B                                                                            B
B                     B                                                                            B
B                     BBBBBBBBBBBBBBBBBBBBBBBBBBBBBB                                               B
B                                                                                                  B
B                                                                                                  B
B                                                                                                  B
B                                                                                                  B
B                                                                                                  B
B                                                                                                  B
B                                                                                                  B
BBBBBBBBBBBBBBBBBBBBBBBBBBBBBBBBBBBBBBBBBBBBBBBBBBBBBBBBBBBBBBBBBBBBBBBBBBBBBBBBBBBBBBBBBBBBBBBBBBBB
